415 415 415 415 415 415 415 415 415 415 415 418 418 418 418 418 418 418 043 418
415 415 415 415 415 415 415 415 415 415 415 418 418 418 418 418 418 418 382 418
415 415 415 415 415 415 415 415 415 415 415 418 418 418 418 418 418 418 382 418
415 415 415 415 415 415 415 415 415 415 415 418 384 383 383 260 383 383 386 418
415 415 415 415 415 415 415 415 415 415 415 418 382 418 418 418 418 418 418 418
415 415 415 415 415 415 418 418 418 418 418 418 382 418 418 418 418 418 418 418
415 415 415 415 415 418 384 383 383 260 383 383 386 415 415 415 415 415 415 415
415 415 415 415 415 418 382 418 418 418 418 418 418 415 415 415 415 415 415 415
415 415 418 418 418 418 382 418 418 418 418 415 415 415 415 415 415 415 415 415
415 415 418 418 418 418 387 383 383 385 418 415 415 415 415 415 415 415 415 415
415 415 418 418 418 418 418 418 418 259 418 415 415 415 415 415 415 415 415 415
415 415 418 384 383 383 260 383 383 386 418 415 415 415 415 415 415 415 415 415
415 415 418 382 418 418 418 418 418 418 418 415 415 415 415 415 415 415 415 415
415 415 418 382 418 418 418 418 418 418 418 415 415 415 415 415 415 415 415 415
415 415 418 387 383 383 385 418 418 415 415 415 415 415 415 415 415 415 415 415
415 415 418 418 418 418 259 418 418 415 415 415 415 415 415 415 415 415 415 415
415 415 415 415 415 418 382 418 418 418 415 415 415 415 415 415 415 415 415 415
415 415 418 384 383 383 386 418 418 418 415 415 415 415 415 415 415 415 415 415
415 415 418 382 418 418 418 418 418 418 415 415 415 415 415 415 415 415 415 415
415 415 415 382 415 415 415 415 415 415 415 415 415 415 415 415 415 415 415 415