091 091 091 091 091 091 091 090 111 090 222 090 091 091 091 222 222 222 222 222
091 073 073 073 073 073 111 111 090 111 090 222 222 076 080 081 081 081 080 222
091 087 046 046 086 418 418 418 418 418 066 066 077 057 080 065 065 065 080 222
091 111 111 111 045 418 384 383 383 383 074 066 077 057 080 065 065 065 080 222
091 073 073 111 045 418 382 111 111 111 059 222 077 057 080 065 065 065 080 222
091 073 073 111 045 418 382 111 088 111 059 222 077 057 080 080 078 080 080 222
091 065 065 111 045 418 382 111 088 111 059 222 077 057 065 222 059 222 222 222
091 065 065 111 045 418 382 111 088 111 059 222 077 057 065 222 059 222 089 089
091 111 111 111 045 418 382 111 088 111 059 222 077 057 065 222 059 222 089 089
415 111 384 383 050 383 386 111 088 111 059 222 077 057 065 222 061 074 222 067
415 111 382 111 045 111 111 111 088 111 059 222 077 057 066 066 222 059 222 067
415 111 382 111 047 046 046 046 046 046 063 056 056 062 067 067 222 059 222 067
415 111 382 111 111 111 111 111 111 111 059 066 070 070 067 067 222 059 222 067
415 111 387 385 111 072 073 073 073 111 059 066 070 070 067 067 222 059 222 067
091 073 111 382 111 072 073 054 073 111 059 222 222 058 056 056 056 063 056 053
091 073 111 382 111 072 073 045 073 111 059 222 222 057 065 065 065 059 066 066
091 073 111 382 111 072 073 045 073 111 061 060 060 064 060 060 060 055 222 222
091 073 111 382 111 072 073 045 073 111 222 222 222 057 222 222 222 222 222 222
111 111 111 068 111 072 073 045 073 073 065 065 065 057 222 222 065 065 222 222
111 111 111 111 111 091 091 047 046 046 056 056 056 062 222 222 065 065 222 222 