207 208 208 208 208 208 208 208 208 208 208 208 208 208 208 208 208 208 208 208 208 208 208 208 208 208 208 208 208 208 208 208 209
230 024 024 024 024 024 024 024 024 024 024 024 024 024 024 024 024 024 024 024 024 024 024 024 024 024 024 024 024 024 024 024 232
230 047 047 047 047 047 047 047 047 047 047 047 047 047 047 047 047 047 047 047 047 047 047 047 047 047 047 047 047 047 004 024 232
230 001 001 001 001 001 001 001 001 001 001 001 001 001 001 001 001 001 001 001 001 001 001 001 001 001 001 001 001 002 023 024 232
230 024 024 024 024 024 024 024 024 024 024 024 024 024 024 024 024 024 024 024 024 024 024 024 024 024 024 024 024 025 023 024 232
230 024 003 047 047 047 047 047 047 047 047 047 047 047 047 047 047 047 047 047 047 047 047 047 047 047 047 047 047 048 023 024 232
230 024 025 000 001 001 001 001 001 001 001 001 001 001 001 001 001 001 001 001 001 001 001 001 001 001 001 001 001 001 027 024 232
230 024 025 023 024 024 024 024 024 024 024 024 024 024 024 024 024 024 024 024 024 024 024 024 024 024 024 024 024 024 024 024 232
230 024 025 046 047 047 047 047 047 047 047 047 047 047 047 047 047 047 047 047 047 047 047 047 047 047 047 047 047 047 004 024 232
230 024 026 001 001 001 001 001 001 001 001 001 001 001 001 001 001 001 001 001 001 001 001 001 001 001 001 001 001 002 023 024 232
230 024 024 024 024 024 024 024 024 024 024 024 024 024 024 024 024 024 024 024 024 024 024 024 024 024 024 024 024 025 023 024 232
230 024 003 047 047 047 047 047 047 047 047 047 047 047 047 047 047 047 047 047 047 047 047 047 047 047 047 047 047 048 023 024 232
230 024 025 000 001 001 001 001 001 001 001 001 001 001 001 001 001 001 001 001 001 001 001 001 001 001 001 001 001 001 027 024 232
230 024 025 023 024 024 024 024 024 024 024 024 024 024 024 024 024 024 024 024 024 024 024 024 024 024 024 024 024 024 024 024 232
230 024 025 023 024 024 024 024 024 024 024 024 024 024 024 024 024 024 024 024 024 024 024 024 024 024 024 024 024 024 024 024 232
230 024 025 023 024 024 024 024 024 024 024 024 024 024 024 024 024 024 024 024 024 024 024 024 024 024 024 024 024 024 024 024 232
253 254 254 254 254 254 254 254 254 254 254 254 254 254 254 254 254 254 254 254 254 254 254 254 254 254 254 254 254 254 254 254 255