091 091 091 091 091 091 091 090 111 090 111 090 091 091 091 111 111 111 111 111
091 073 073 073 073 073 111 111 090 111 090 111 111 076 080 081 081 081 080 111
091 087 046 046 086 418 418 418 418 418 066 066 077 057 080 065 065 065 080 111
091 111 111 111 045 418 384 383 383 383 074 066 077 057 080 065 065 065 080 111
091 073 073 111 045 418 382 111 111 111 059 111 077 057 080 065 065 065 080 111
091 073 073 111 045 418 382 111 088 111 059 111 077 057 080 080 078 080 080 111
091 065 065 111 045 418 382 111 088 111 059 111 077 057 065 111 059 111 111 111
091 065 065 111 045 418 382 111 088 111 059 111 077 057 065 111 059 111 089 089
091 111 111 111 045 418 382 111 088 111 059 111 077 057 065 111 059 111 089 089
415 111 384 383 050 383 386 111 088 111 059 111 077 057 065 111 061 060 074 067
415 111 382 111 045 111 111 111 088 111 059 111 077 057 066 066 111 059 111 067
415 111 382 111 047 046 046 046 046 046 063 056 056 062 067 067 111 059 111 067
415 111 382 111 111 111 111 111 111 111 059 066 070 070 067 067 111 059 111 067
415 111 387 385 111 072 073 073 073 111 059 066 070 070 067 067 111 059 111 067
091 111 111 382 111 072 073 054 073 111 059 111 111 058 056 056 056 063 056 053
091 071 111 382 111 072 073 045 073 111 059 111 111 057 065 065 065 059 066 066
091 071 111 382 111 072 073 045 073 111 061 060 060 064 060 060 060 055 111 111
091 071 111 382 111 072 073 045 073 111 111 111 111 057 111 111 111 111 111 111
111 111 111 068 111 072 073 045 073 073 065 065 065 057 111 111 065 065 111 111
111 111 111 111 111 091 091 047 046 046 056 056 056 062 111 111 065 065 111 111 